##########
#    A   #
## ##### #
#  # #B# #
##     # #
##########