##########
# A      #
## ##### #
#  # #B  #
##     # #
##########